Sword:: Fast attacking, average damage, melee weapon
Axe:: Throws a boomerang which comes back to you,<br>pierces enemies
Bow:: It shots you
Spear:: A slow attacking, high damage, melee weapon
Crossbow:: Shoots fast, low damage, piercing arrows
Shuriken:: Throws a spinning projectile which deals<br>damage over time as enemies touch it.
Boomerang:: Throws a projectile which<br>bounces between enemies
Blowdart:: Slow shooting, high damage, non-piercing projectiles.
Dagger:: Fast throwing, low damage, trio of non-piercing projectiles.
Rock:: "It's a rock, what more did you expect?"
Emerald:: ooo shiny
Gold:: GOLD!
Slime:: Sticky and gross
Shungite:: It has a protective feeling
Morkite:: "Mission Control is displeased, get back to work."
Void:: Unstable Substance
Amethyst:: PORPOL
Angelic Ingot:: Holy Canole
Demonic Ingot:: Unholy Uncanole
Glass:: Sharp!
Aquarq:: "Molly! Where are you?"
Zebrium:: "It's striped, it's strapped, and it's stripped."
Branch:: Feels kinda tickly
Infused Rock:: Gives off an ominous aura
Plastic:: Seems hollow, feels smooth
Bone:: Disturbingly warm
Diamond:: I CAN SWING MY SWORD!
Piss:: Smells tasty
Grappling:: Launch a <o>Grappling Hook</> which pulls you toward itself when it lands.
Capitalism:: Spend 1 <o>Coin</> to instantly kill the 3 nearest <e>Enemies</>. 
SoulDrain:: All nearby <e>Enemies</> drop x2 their kill reward, but become <o>Soulless</>.<br><o>Soulless</> <e>Enemies</> do not drop a kill reward on death.
ArrowStorm:: Shoot an arc of <o>Arrows</> with 50% Damage.
Rune Of Self:: <g>+25%</> chance to Heal 1 on Hit
Rune Of Missile:: <g>+10%</> chance on Hit to shoot a <o>Missile</> with 200% Damage
Rune Of Confluence:: <g>+35%</> chance on Heal to deal<br>x2 the amount as Damage to the nearest <e>Enemy</>
Rune Of Arrow:: <g>+20%</> chance on Attack to shoot an <o>Arrow</> with 100% Damage
Rune Of Kaboom:: <e>Enemies</> explode on Kill for 15 Damage<br><g>5m (+2m per stack)</> Explosion Size
Rune Of Retaliation:: When taking Damage, deal <g>+50%</> of the Damage to the nearest <e>Enemy</>
Rune Of Soul:: <g>+15%</> chance to spawn an extra <o>Soul</> on kill
Rune Of Splitting:: Damage taken is split evenly between <g>2 (+1 per stack)</> ticks across 3 seconds
Rune Of Retribution:: Explode on taking Damage for 10 Damage<br><g>6m (+2m per stack)</> Explosion Size
Rune Of Luck:: <g>+0.35</> Luck
Rune Of Excitation:: Dealing damage grants you <g>+30%</> Movement Speed<br>This boost decays over <g>1s (+0.5s per stack)</>
Rune Of Barrier:: While in Barrier, gain <g>+20% (asymptotic stacking)</> Block Chance<br>This is unaffected by Luck
Rune Of Collapse:: Damaging an <e>Enemy</> applies <o>Collapse</> which stores <g>+50%</> of Damage dealt<br>Damage the same <e>Enemy</> with the other equipped <o>Weapon</> to deal all <br> stored Damage from <o>Collapse</><br><o>Collapse</> stacks are cleared on release
Rune Of Freeze:: <g>+30%</> chance on Hit to apply a stack of <o>Freeze</><br><o>Freeze</> reduces Movement Speed by 50% per stack for 5s
Rune Of Bleed:: <g>+20%</> chance on Hit to apply a stack of <o>Bleed</><br><o>Bleed</> deals 3 (+3 per stack) Damage per second for 3s
Rune Of Consumption:: Clear all <o>Effects</> on an <e>Enemy</>, for each stack cleared<br>increase Total Damage Dealt by <g>+20%</>
Rune Of Investment:: <g>+1%</> Total Damage per <o>Coin</> currently held
Rune Of Dashed Protection:: <g>+0.2s</> of Dash Invulnerability
Rune Of Surge:: 15% chance on Kill to refill all skills by <g>+1</> Stock
Rune Of Life:: 25% chance on Heal to increase amount healed by <g>+1</>
Rune Of Death:: 25% chance on Hit to increase Damage dealt by <g>+3</>
Rune Of Ballistics:: On Skill shoot a <o>Missile</> with <g>+50%</> Damage
Rune Of Electricity:: On Skill shoot <o>Lightning</> with <g>+20%</> Damage (max of 4 bounces)